D39555553D53
BC695153C552
853A96D2B956
C3C6A93C6C53
BABF86AFFF96
AC2FC7857FAB
A96FFFAFFFC2
AC53BFAFD516
853C2FAFFFAB
AD47ABC517AA
A9396C39696A
C6C4556C5456

9,1
9,11
EESWWSEESWSSESWSSSWS
